+ ;- ;- ;- ;- ;- ;- ;- ;- ;- ;- ;- ;- ;- ;- ;- ;- ;- ;- ;- ;- ;- ;+ 
| ;>1;  ;  ;  ;  ;  ;  ;  ;  ;  ;  ;  ;  ;  ;  ;  ;  ;  ;  ;  ;v2;| 
| ;  ;+ ;  ;+ ;  ;+ ;  ;+ ;  ;+ ;  ;+ ;  ;+ ;  ;+ ;  ;+ ;  ;+ ;  ;| 
| ;  ;  ;  ;  ;  ;  ;  ;  ;  ;  ;  ;  ;  ;  ;  ;  ;  ;  ;  ;  ;  ;| 
| ;  ;+ ;  ;+ ;  ;+ ;  ;+ ;  ;+ ;  ;+ ;  ;+ ;  ;+ ;  ;+ ;  ;+ ;  ;| 
| ;  ;  ;  ;  ;  ;  ;  ;  ;  ;  ;  ;  ;  ;  ;  ;  ;  ;  ;  ;  ;  ;| 
| ;  ;+ ;  ;+ ;  ;+ ;  ;+ ;  ;+ ;  ;+ ;  ;+ ;  ;+ ;  ;+ ;  ;+ ;  ;| 
| ;  ;  ;  ;  ;  ;  ;  ;  ;  ;  ;  ;  ;  ;  ;  ;  ;  ;  ;  ;  ;  ;| 
| ;  ;+ ;  ;+ ;  ;+ ;  ;+ ;  ;+ ;  ;+ ;  ;+ ;  ;+ ;  ;+ ;  ;+ ;  ;| 
| ;  ;  ;  ;  ;  ;  ;  ;  ;  ;  ;  ;  ;  ;  ;  ;  ;  ;  ;  ;  ;  ;| 
| ;  ;+ ;  ;+ ;  ;+ ;  ;+ ;  ;+ ;  ;+ ;  ;+ ;  ;+ ;  ;+ ;  ;+ ;  ;| 
| ;  ;  ;  ;  ;  ;  ;  ;  ;  ;  ;  ;  ;  ;  ;  ;  ;  ;  ;  ;  ;  ;| 
| ;  ;+ ;  ;+ ;  ;+ ;  ;+ ;  ;+ ;  ;+ ;  ;+ ;  ;+ ;  ;+ ;  ;+ ;  ;| 
| ;  ;  ;  ;  ;  ;  ;  ;  ;  ;  ;  ;  ;  ;  ;  ;  ;  ;  ;  ;  ;  ;| 
| ;  ;+ ;  ;+ ;  ;+ ;  ;+ ;  ;+ ;  ;+ ;  ;+ ;  ;+ ;  ;+ ;  ;+ ;  ;| 
| ;  ;  ;  ;  ;  ;  ;  ;  ;  ;  ;  ;  ;  ;  ;  ;  ;  ;  ;  ;  ;  ;| 
| ;  ;+ ;  ;+ ;  ;+ ;  ;+ ;  ;+ ;  ;+ ;  ;+ ;  ;+ ;  ;+ ;  ;+ ;  ;| 
| ;  ;  ;  ;  ;  ;  ;  ;  ;  ;  ;  ;  ;  ;  ;  ;  ;  ;  ;  ;  ;  ;| 
| ;  ;+ ;  ;+ ;  ;+ ;  ;+ ;  ;+ ;  ;+ ;  ;+ ;  ;+ ;  ;+ ;  ;+ ;  ;| 
| ;  ;  ;  ;  ;  ;  ;  ;  ;  ;  ;  ;  ;  ;  ;  ;  ;  ;  ;  ;  ;  ;| 
| ;  ;+ ;  ;+ ;  ;+ ;  ;+ ;  ;+ ;  ;+ ;  ;+ ;  ;+ ;  ;+ ;  ;+ ;  ;| 
| ;^4;  ;  ;  ;  ;  ;  ;  ;  ;  ;  ;  ;  ;  ;  ;  ;  ;  ;  ;  ;<3;| 
+ ;- ;- ;- ;- ;- ;- ;- ;- ;- ;- ;- ;- ;- ;- ;- ;- ;- ;- ;- ;- ;- ;+ 