+ ;>1;§1;  ;  ;  ;  ;  ;  ;v2
+ ;  ;+ ;- ;- ;- ;+ ;- ;+ ;  
| ;  ;  ;  ;  ;  ;  ;  ;| ;  
+ ;  ;+ ;- ;- ;- ;+ ;  ;+ ;  
| ;  ;| ;  ;  ;@1;| ;  ;| ;  
| ;  ;| ;  ;+ ;- ;+ ;  ;| ;  
| ;  ;| ;  ;  ;  ;  ;  ;| ;  
+ ;  ;+ ;- ;- ;- ;+ ;- ;+ ;  
| ;^4;  ;  ;  ;  ;  ;  ;  ;<3
+ ;- ;+ ;- ;- ;- ;+ ;- ;+ ;+ 