+ ;  ;  ;  ;  ;  ;  ;  ;  ;  ;  ;  ;  ;  ;  ;  ;  ;  ;  ;  ;  ;  
| ;  ;+ ;- ;- ;- ;- ;- ;- ;- ;- ;- ;- ;- ;- ;- ;- ;- ;- ;- ;+ ;  
| ;  ;  ;  ;  ;  ;  ;  ;  ;  ;  ;  ;  ;  ;  ;  ;  ;  ;  ;  ;| ;  
| ;  ;+ ;- ;- ;- ;- ;- ;- ;- ;- ;- ;- ;- ;- ;- ;- ;- ;+ ;  ;| ;  
| ;  ;| ;  ;  ;  ;  ;  ;  ;  ;  ;  ;  ;  ;  ;  ;  ;  ;| ;  ;| ;  
| ;  ;| ;  ;+ ;- ;- ;- ;- ;- ;- ;- ;- ;- ;- ;- ;+ ;  ;| ;  ;| ;  
| ;  ;| ;  ;  ;  ;  ;  ;  ;  ;  ;  ;  ;  ;  ;  ;| ;  ;| ;  ;| ;  
| ;  ;| ;  ;+ ;- ;- ;- ;- ;- ;- ;- ;- ;- ;+ ;  ;| ;  ;| ;  ;| ;  
| ;  ;| ;  ;  ;  ;  ;  ;  ;  ;  ;  ;  ;  ;| ;  ;| ;  ;| ;  ;| ;  
| ;  ;| ;  ;+ ;  ;+ ;  ;+ ;  ;+ ;  ;+ ;  ;| ;  ;| ;  ;| ;  ;| ;  
| ;  ;| ;  ;| ;  ;  ;  ;  ;  ;  ;  ;  ;  ;| ;  ;| ;  ;| ;  ;| ;  
| ;  ;| ;  ;| ;  ;+ ;  ;+ ;  ;+ ;  ;+ ;  ;| ;  ;| ;  ;| ;  ;| ;  
| ;  ;| ;  ;| ;  ;  ;  ;  ;  ;  ;  ;  ;  ;| ;  ;| ;  ;| ;  ;| ;  
| ;  ;| ;  ;| ;  ;+ ;- ;- ;- ;- ;- ;- ;- ;+ ;  ;| ;  ;| ;  ;| ;  
| ;  ;| ;  ;| ;  ;  ;  ;  ;  ;  ;  ;  ;  ;  ;  ;| ;  ;| ;  ;| ;  
| ;  ;| ;  ;| ;  ;+ ;- ;- ;- ;- ;- ;- ;- ;- ;- ;+ ;  ;| ;  ;| ;  
| ;  ;| ;  ;| ;  ;  ;  ;  ;  ;  ;  ;  ;  ;  ;  ;  ;  ;| ;  ;| ;  
| ;  ;| ;  ;+ ;- ;- ;- ;- ;- ;- ;- ;- ;- ;- ;- ;- ;- ;+ ;  ;| ;  
| ;  ;| ;  ;  ;  ;  ;  ;  ;  ;  ;  ;  ;  ;  ;  ;  ;  ;  ;  ;| ;  
| ;  ;+ ;- ;- ;- ;- ;- ;- ;- ;- ;- ;- ;- ;- ;- ;- ;- ;- ;- ;+ ;  
| ;  ;  ;  ;  ;  ;  ;  ;  ;  ;  ;  ;  ;  ;  ;  ;  ;  ;  ;  ;  ; 
+ ;- ;- ;- ;- ;- ;- ;- ;- ;- ;- ;- ;- ;- ;- ;- ;- ;- ;- ;- ;- ;+ 